####################################
#..................................#
#..................................#
#..................................#
#..................................#
#..................................#
#..................................#
#..................................#
#..................................#
#..................................#
#..................................#
#..................................#
#..................................#
############D#######################
