29
############################
#..........................#
#..........................#
#..........................#
#..........................#
#..........................#
#..........................#
#######D####################
