###########D########################
#..................................#
#..................................#
#..................................#
#..................................#
#..................................#
#..................................#
#..................................#
#..................................#
#..................................D
#..................................#
#..................................#
#..................................#
####################################
