21
#####D##############
#..................#
#..................#
#..................#
#..................#
#..................#
#..................#
#..................#
#..................#
#..................#
#..................#
#..................#
#..................D
#..................#
#..................#
#..................#
#..................#
###################
