####################################
#..................................#
#..................................#
#..................................#
#..................................#
#..................................#
#..................................#
#..................................#
#..................................#
D..................................#
#..................................#
#..................................#
#..................................#
####################################
