26
#########################
#.......................#
#.......................#
#.......................#
#.......................#
#######D#################
