######D#######################
#............................#
#............................#
#............................#
#............................#
#............................#
#............................#
#............................#
#............................#
#............................D
#............................#
##############################
