17
################
#..............#
#..............#
#..............#
#..............#
#..............#
#..............#
#..............#
#..............#
D..............#
#..............#
#..............#
#..............#
#..............#
################
